"a" = (/turf/closed/wall/f13/vault,/area/shuttle/brotherhood_of_steel)
"b" = (/obj/structure/ladder/unbreakable{height = 2; id = "NW"},/turf/open/floor/plasteel/dark,/area/shuttle/brotherhood_of_steel)
"c" = (/turf/open/floor/plasteel/dark,/area/shuttle/brotherhood_of_steel)
"d" = (/obj/structure/ladder/unbreakable{anchored = 1; height = 2; id = "NE"},/turf/open/floor/plasteel/dark,/area/shuttle/brotherhood_of_steel)
"e" = (/obj/machinery/computer/shuttle/bos,/turf/open/floor/plasteel/dark,/area/shuttle/brotherhood_of_steel)
"f" = (/obj/machinery/light{dir = 8; light_color = "#e8eaff"},/obj/structure/ladder/unbreakable{height = 2; id = "SW"},/turf/open/floor/plasteel/dark,/area/shuttle/brotherhood_of_steel)
"g" = (/obj/structure/ladder/unbreakable{height = 2; id = "SE"},/turf/open/floor/plasteel/dark,/area/shuttle/brotherhood_of_steel)
"h" = (/turf/template_noop,/area/template_noop)
"i" = (/obj/item/flag/bos,/turf/open/floor/plasteel/dark,/area/shuttle/brotherhood_of_steel)
"j" = (/obj/docking_port/mobile/bos{dwidth = 1; name = "Broterhood_of_Steel"},/obj/machinery/door/airlock/hatch{req_access_txt = "120"},/turf/open/floor/plasteel/dark,/area/shuttle/brotherhood_of_steel)

(1,1,1) = {"
aaaaaaaaa
jccccccia
aaaccccca
hhabcdcca
hhafcgcea
hhaaaaaaa
"}
