"a" = (/turf/closed/wall/f13/tentwall,/area/survivalpod)
"b" = (/obj/structure/table,/obj/machinery/chem_dispenser/drinks{dir = 4},/turf/open/indestructible/ground/outside/dirt{dir = 8; icon_state = "dirt"; tag = "icon-dirt (WEST)"},/area/survivalpod)
"c" = (/turf/open/indestructible/ground/outside/dirt{dir = 8; icon_state = "dirtcorner"},/area/survivalpod)
"d" = (/obj/structure/chair/f13chair2,/turf/open/indestructible/ground/outside/dirt{dir = 1; icon_state = "dirt"},/area/survivalpod)
"e" = (/obj/structure/table,/turf/open/floor/plating/f13/outside/desert,/area/survivalpod)
"g" = (/obj/structure/campfire/stove,/turf/open/indestructible/ground/outside/dirt,/area/survivalpod)
"m" = (/turf/open/indestructible/ground/outside/dirt{dir = 1; icon_state = "dirtcorner"},/area/survivalpod)
"n" = (/obj/structure/closet/fridge/standard{anchored = 1},/obj/item/reagent_containers/food/condiment/flour,/obj/item/reagent_containers/food/condiment/flour,/obj/item/reagent_containers/food/condiment/flour,/obj/item/reagent_containers/food/condiment/flour,/obj/item/reagent_containers/food/condiment/flour,/obj/item/reagent_containers/food/condiment/rice,/obj/item/reagent_containers/food/condiment/rice,/obj/item/reagent_containers/food/condiment/rice,/obj/item/reagent_containers/food/condiment/rice,/obj/item/reagent_containers/food/condiment/rice,/obj/item/reagent_containers/food/condiment/soysauce,/obj/item/reagent_containers/food/condiment/soysauce,/obj/item/reagent_containers/food/condiment/soysauce,/obj/item/reagent_containers/food/condiment/milk,/obj/item/reagent_containers/food/condiment/milk,/obj/item/reagent_containers/food/condiment/milk,/obj/item/reagent_containers/food/condiment/milk,/obj/item/reagent_containers/food/condiment/milk,/obj/item/reagent_containers/food/condiment/saltshaker,/obj/item/reagent_containers/food/condiment/peppermill,/obj/item/reagent_containers/food/snacks/grown/tomato,/obj/item/reagent_containers/food/snacks/grown/tomato,/obj/item/reagent_containers/food/snacks/grown/tomato,/obj/item/reagent_containers/food/snacks/grown/tomato,/obj/item/reagent_containers/food/snacks/grown/tomato,/obj/item/reagent_containers/food/snacks/grown/carrot,/obj/item/reagent_containers/food/snacks/grown/carrot,/obj/item/reagent_containers/food/snacks/grown/potato,/obj/item/reagent_containers/food/snacks/grown/potato,/obj/item/reagent_containers/food/snacks/grown/potato,/obj/item/reagent_containers/food/condiment/peppermill,/obj/item/reagent_containers/food/condiment/saltshaker,/turf/open/indestructible/ground/outside/dirt,/area/survivalpod)
"o" = (/obj/structure/simple_door/tent,/turf/open/indestructible/ground/outside/dirt{dir = 4; icon_state = "dirt"},/area/survivalpod)
"q" = (/obj/structure/table,/obj/machinery/reagentgrinder{pixel_y = 14},/turf/open/indestructible/ground/outside/dirt,/area/survivalpod)
"r" = (/obj/structure/table,/obj/item/storage/box/drinkingglasses,/obj/item/storage/box/drinkingglasses,/turf/open/indestructible/ground/outside/dirt{dir = 9; icon_state = "dirt"; tag = "icon-dirt (NORTHWEST)"},/area/survivalpod)
"s" = (/obj/structure/sink{dir = 8; icon_state = "sink"; pixel_x = -13; pixel_y = 0; tag = "icon-sink (WEST)"},/turf/open/indestructible/ground/outside/dirt,/area/survivalpod)
"w" = (/turf/open/indestructible/ground/outside/dirt,/area/survivalpod)
"x" = (/obj/structure/table,/obj/item/storage/box/ingredients/delights,/obj/item/storage/box/ingredients/wildcard,/obj/item/storage/box/ingredients/wildcard,/obj/item/storage/box/ingredients/wildcard,/obj/item/storage/box/ingredients/wildcard,/obj/item/storage/box/ingredients/wildcard,/turf/open/indestructible/ground/outside/dirt,/area/survivalpod)
"y" = (/turf/open/indestructible/ground/outside/dirt{dir = 1; icon_state = "dirt"},/area/survivalpod)
"z" = (/obj/structure/table,/obj/item/storage/bag/tray,/obj/item/reagent_containers/food/condiment/yeast,/obj/item/reagent_containers/food/condiment/ketchup,/obj/item/reagent_containers/food/condiment/ketchup,/turf/open/indestructible/ground/outside/dirt,/area/survivalpod)
"B" = (/obj/structure/chair/f13chair2{dir = 1; icon_state = "f13chair2"},/turf/open/indestructible/ground/outside/dirt{icon_state = "dirt"},/area/survivalpod)
"C" = (/obj/structure/table,/obj/machinery/processor/chopping_block,/turf/open/indestructible/ground/outside/dirt,/area/survivalpod)
"D" = (/obj/structure/table,/obj/item/storage/box/ingredients/grains,/obj/item/kitchen/knife,/obj/item/reagent_containers/food/snacks/store/cheesewheel,/obj/item/reagent_containers/food/snacks/store/cheesewheel,/obj/item/reagent_containers/food/snacks/store/cheesewheel,/turf/open/indestructible/ground/outside/dirt,/area/survivalpod)
"E" = (/turf/open/floor/plating/f13/outside/desert,/area/survivalpod)
"I" = (/obj/structure/chair/f13chair2{dir = 1; icon_state = "f13chair2"},/turf/open/floor/plating/f13/outside/desert,/area/survivalpod)
"J" = (/obj/structure/table,/obj/machinery/microwave,/turf/open/indestructible/ground/outside/dirt{dir = 10; icon_state = "dirt"; tag = "icon-dirt (SOUTHWEST)"},/area/survivalpod)
"P" = (/turf/open/indestructible/ground/outside/dirt{dir = 8; icon_state = "dirt"},/area/survivalpod)
"Q" = (/obj/structure/closet/fridge/standard{anchored = 1},/obj/item/reagent_containers/food/snacks/meat/slab,/obj/item/reagent_containers/food/snacks/meat/slab,/obj/item/reagent_containers/food/snacks/meat/slab,/obj/item/reagent_containers/food/snacks/meat/slab,/obj/item/reagent_containers/food/snacks/meat/slab,/obj/item/reagent_containers/food/snacks/meat/slab,/obj/item/reagent_containers/food/snacks/meat/slab,/obj/item/reagent_containers/food/snacks/meat/slab,/obj/item/reagent_containers/food/snacks/meat/slab,/obj/item/reagent_containers/food/snacks/meat/slab,/obj/item/reagent_containers/food/snacks/meat/slab,/obj/item/reagent_containers/food/snacks/meat/slab,/obj/item/reagent_containers/food/snacks/meat/slab,/obj/item/reagent_containers/food/snacks/meat/slab,/obj/item/reagent_containers/food/snacks/meat/slab,/obj/item/reagent_containers/food/snacks/meat/slab,/obj/item/reagent_containers/food/snacks/meat/slab,/obj/item/reagent_containers/food/snacks/meat/slab,/obj/item/reagent_containers/food/snacks/meat/slab,/obj/item/reagent_containers/food/snacks/meat/slab,/obj/item/reagent_containers/food/snacks/grown/corn,/obj/item/reagent_containers/food/snacks/grown/corn,/obj/item/reagent_containers/food/snacks/grown/corn,/obj/item/reagent_containers/food/snacks/grown/grapes,/obj/item/reagent_containers/food/snacks/grown/grapes,/obj/item/reagent_containers/food/snacks/grown/grapes,/obj/item/reagent_containers/food/snacks/grown/grapes/green,/obj/item/reagent_containers/food/snacks/grown/grapes/green,/obj/item/reagent_containers/food/snacks/grown/grapes/green,/turf/open/indestructible/ground/outside/dirt,/area/survivalpod)
"R" = (/obj/machinery/deepfryer,/turf/open/indestructible/ground/outside/dirt,/area/survivalpod)
"W" = (/obj/structure/table,/obj/machinery/chem_dispenser/drinks/beer{dir = 4},/turf/open/indestructible/ground/outside/dirt{dir = 8; icon_state = "dirt"; tag = "icon-dirt (WEST)"},/area/survivalpod)
"X" = (/obj/structure/chair/f13chair2,/turf/open/floor/plating/f13/outside/desert,/area/survivalpod)
"Y" = (/turf/open/indestructible/ground/outside/dirt{icon_state = "dirt"},/area/survivalpod)

(1,1,1) = {"
aaaaaaaaEEEEEEEaa
agxDQaEEEXXXXXXEa
awwwwbEEEeeeeeeEE
aswwwJYYYBBBBBBYc
owRqwwwwwwwwwwwwP
aswwwryyyddddddym
awwwwWEEEeeeeeeEE
agCznaEEEIIIIIIEa
aaaaaaaaEEEEEEEaa
"}
